Suggested Words for the errors

keyboard: board record error heart records period february memory standard second
contest: content contact costs months latest comment control center cases points
bands: cards basic cases makes james words thanks parts means needs
suitable: table simple style single little title state usually finance final
millions: million miles options listings methods various videos minutes island region
lunch: quick linux watch beach month march since links which later
audit: audio india submit adult radio added august april again credit
chamber: chapter camera changes change member number later cases choose james
guinea: guide china given going quick india points linux gifts thing
findings: listings india reading finance living building things windows listing points
muscle: mobile music whole quick simple models europe rules miles style
clicking: living looking listing click listings planning making building working shipping
polls: tools posts models points words deals rules works miles parts
typical: topics topic medical lyrics final official social digital total special
tower: power cover poker later taken powered color enter offer paper
yours: hours court young course years words works sound costs groups
chicken: children check click quick taken chapter choose tickets written child
attend: often added friend around after later taken amount getting third
shower: shower power whole cover short share seller poker stores server
sending: reading getting meeting being india thing hosting planning living studies
jason: basic cases taken james major person yahoo based later known
tonight: night weight might light right though topics months month topic
holdem: whole model house hotel order models choose words often cover
shell: shall still small shell whole cheap style short share child
province: provide provides provided profile price points france notice movie point
catholic: topic basic whole methods choose though economic topics called color
governor: error cover given november together average period director powered several
seemed: seller server second series received james submit sound style record
swimming: shipping living building working listing shopping within simple listings domain
spyware: share space software update style powered start compare place power
formula: format forums forum florida popular found family could world would